0000000000000043
0000000000000043
0000000000000053
0000000000000043
0000000000000053
0000000000000043
7777777777777753
7777777777777743
7777777777777763
7777777777777743
7722222222222222
7722222222222222